 1| 1| 1| 1| 1| 1| 1| 1| 1| 1| 1| 1| 1| 1| 1| 1
 1| 1| 1| 1| 1| 1| 1| 1| 1| 1| 1| 1| 1| 1| 1| 1
 1| 1| 1| 1| 1| 1| 1| 8| 8| 8| 8| 8| 1| 1| 1| 1
 1| 1| 1| 1| 1| 1| 1| 8| 2| 7| 2| 8| 8| 8| 1| 1
 1| 1| 1| 1| 1| 1| 8| 8| 2| 2| 2| 2| 2| 8| 1| 1
 1| 1| 1| 1| 1| 1| 8| 5| 2| 3| 5| 3| 2| 8| 1| 1
 1| 1| 1| 1| 1| 1| 8| 8| 2| 8| 2| 8| 8| 8| 1| 1
 1| 1| 1| 1| 1| 1| 1| 8| 2| 2| 2| 8| 1| 1| 1| 1
 1| 1| 1| 1| 1| 1| 1| 8| 8| 8| 8| 8| 1| 1| 1| 1
 1| 1| 1| 1| 1| 1| 1| 1| 1| 1| 1| 1| 1| 1| 1| 1
 1| 1| 1| 1| 1| 1| 1| 1| 1| 1| 1| 1| 1| 1| 1| 1
 1| 1| 1| 1| 1| 1| 1| 1| 1| 1| 1| 1| 1| 1| 1| 1
