 8| 8| 8| 8| 8| 8| 8| 8| 8| 8| 8| 8| 8| 8| 8| 8
 8| 8| 8| 8| 8| 8| 8| 8| 8| 8| 8| 8| 8| 8| 8| 8
 8| 8| 5| 2| 8| 8| 8| 8| 8| 8| 7| 8| 8| 8| 8| 8
 8| 8| 5| 2| 2| 2| 8| 8| 8| 8| 2| 8| 8| 8| 8| 8
 8| 8| 5| 2| 2| 2| 2| 2| 8| 8| 2| 8| 2| 2| 8| 8
 8| 8| 8| 8| 2| 8| 2| 2| 2| 2| 2| 2| 2| 3| 8| 8
 8| 8| 8| 8| 2| 2| 2| 8| 2| 8| 8| 8| 8| 2| 8| 8
 8| 8| 8| 8| 2| 8| 2| 8| 2| 2| 2| 2| 2| 2| 2| 8
 8| 8| 8| 2| 3| 8| 2| 8| 2| 8| 2| 3| 2| 2| 2| 8
 8| 8| 8| 2| 2| 2| 2| 2| 2| 2| 2| 2| 2| 8| 8| 8
 8| 8| 8| 8| 8| 8| 8| 8| 8| 8| 8| 8| 8| 8| 8| 8
 8| 8| 8| 8| 8| 8| 8| 8| 8| 8| 8| 8| 8| 8| 8| 8
