 1| 1| 1| 1| 1| 1| 1| 1| 1| 1| 1| 1| 1| 1| 1| 1
 1| 1| 1| 1| 1| 1| 1| 1| 1| 1| 1| 1| 1| 1| 1| 1
 1| 1| 1| 1| 1| 8| 8| 8| 8| 1| 1| 1| 1| 1| 1| 1
 1| 1| 1| 1| 1| 8| 2| 2| 8| 8| 8| 8| 8| 8| 8| 1
 1| 1| 1| 1| 1| 8| 2| 2| 2| 2| 3| 5| 3| 2| 8| 1
 1| 1| 1| 1| 1| 8| 2| 2| 5| 8| 2| 5| 2| 2| 8| 1
 1| 1| 1| 1| 1| 8| 2| 2| 5| 8| 3| 7| 3| 8| 8| 1
 1| 1| 1| 1| 1| 8| 8| 8| 2| 2| 2| 2| 2| 8| 1| 1
 1| 1| 1| 1| 1| 1| 1| 8| 8| 8| 8| 8| 8| 8| 1| 1
 1| 1| 1| 1| 1| 1| 1| 1| 1| 1| 1| 1| 1| 1| 1| 1
 1| 1| 1| 1| 1| 1| 1| 1| 1| 1| 1| 1| 1| 1| 1| 1
 1| 1| 1| 1| 1| 1| 1| 1| 1| 1| 1| 1| 1| 1| 1| 1
