 8| 8| 8| 8| 8| 8| 8| 8| 8| 8| 8| 8| 8| 8| 8| 8
 8| 8| 8| 8| 8| 8| 8| 8| 8| 8| 8| 8| 8| 8| 8| 8
 8| 2| 2| 2| 2| 2| 2| 2| 2| 2| 2| 2| 2| 2| 2| 8
 8| 2| 2| 3| 2| 3| 2| 3| 2| 3| 2| 3| 2| 3| 2| 8
 8| 2| 8| 2| 8| 8| 8| 8| 8| 8| 8| 8| 2| 8| 8| 8
 8| 2| 8| 2| 2| 3| 2| 3| 2| 8| 5| 5| 5| 5| 5| 8
 8| 2| 8| 7| 3| 2| 3| 2| 3| 2| 5| 2| 2| 2| 5| 8
 8| 2| 8| 3| 2| 3| 2| 3| 2| 8| 5| 2| 5| 2| 5| 8
 8| 2| 2| 2| 3| 2| 3| 2| 3| 2| 5| 2| 2| 2| 5| 8
 8| 2| 8| 2| 2| 2| 2| 2| 2| 8| 5| 5| 5| 5| 5| 8
 8| 8| 8| 8| 8| 8| 8| 8| 8| 8| 8| 8| 8| 8| 8| 8
 8| 8| 8| 8| 8| 8| 8| 8| 8| 8| 8| 8| 8| 8| 8| 8
