 8| 8| 8| 8| 8| 8| 8| 8| 8| 8| 8| 8| 8| 8| 8| 8
 8| 8| 8| 8| 8| 8| 8| 8| 8| 8| 8| 8| 8| 8| 8| 8
 8| 8| 8| 8| 8| 8| 8| 8| 8| 8| 8| 8| 8| 8| 8| 8
 8| 8| 2| 2| 8| 8| 8| 8| 8| 8| 8| 8| 2| 2| 8| 8
 8| 8| 2| 3| 2| 8| 2| 5| 5| 2| 8| 2| 3| 2| 8| 8
 8| 8| 2| 2| 3| 3| 3| 5| 5| 3| 3| 3| 2| 2| 8| 8
 8| 8| 8| 2| 2| 2| 3| 5| 2| 2| 2| 2| 2| 2| 8| 8
 8| 8| 8| 7| 2| 8| 5| 5| 5| 5| 8| 2| 2| 8| 8| 8
 8| 8| 8| 8| 8| 8| 8| 8| 8| 8| 8| 8| 8| 8| 8| 8
 8| 8| 8| 8| 8| 8| 8| 8| 8| 8| 8| 8| 8| 8| 8| 8
 8| 8| 8| 8| 8| 8| 8| 8| 8| 8| 8| 8| 8| 8| 8| 8
 8| 8| 8| 8| 8| 8| 8| 8| 8| 8| 8| 8| 8| 8| 8| 8
