 8| 8| 8| 8| 8| 8| 8| 8| 8| 8| 8| 8| 8| 8| 8| 8
 8| 8| 8| 8| 8| 8| 8| 8| 8| 8| 8| 8| 8| 8| 8| 8
 8| 8| 8| 8| 8| 8| 8| 8| 8| 8| 8| 8| 8| 8| 8| 8
 8| 8| 8| 8| 8| 2| 2| 5| 2| 2| 8| 8| 8| 8| 8| 8
 8| 8| 8| 2| 3| 2| 8| 5| 8| 2| 3| 2| 2| 8| 8| 8
 8| 8| 2| 3| 2| 3| 8| 5| 8| 3| 2| 3| 2| 8| 8| 8
 8| 8| 2| 2| 3| 5| 5| 2| 5| 5| 3| 2| 2| 8| 8| 8
 8| 8| 8| 8| 2| 8| 8| 7| 8| 8| 2| 8| 8| 8| 8| 8
 8| 8| 8| 8| 2| 2| 2| 5| 2| 2| 2| 8| 8| 8| 8| 8
 8| 8| 8| 8| 8| 8| 8| 8| 8| 8| 8| 8| 8| 8| 8| 8
 8| 8| 8| 8| 8| 8| 8| 8| 8| 8| 8| 8| 8| 8| 8| 8
 8| 8| 8| 8| 8| 8| 8| 8| 8| 8| 8| 8| 8| 8| 8| 8
