 8| 8| 8| 8| 8| 8| 8| 8| 8| 8| 8| 8| 8| 8| 8| 8
 8| 8| 8| 8| 8| 8| 8| 8| 8| 8| 8| 8| 8| 8| 8| 8
 8| 5| 2| 5| 8| 2| 2| 2| 2| 2| 2| 2| 8| 8| 8| 8
 8| 5| 5| 2| 8| 3| 2| 3| 2| 8| 2| 3| 8| 2| 2| 8
 8| 2| 5| 2| 8| 7| 3| 3| 3| 3| 2| 2| 2| 2| 5| 8
 8| 5| 2| 5| 8| 3| 2| 2| 3| 2| 2| 2| 8| 3| 5| 8
 8| 8| 2| 8| 8| 2| 2| 3| 3| 3| 3| 3| 8| 2| 5| 8
 8| 8| 2| 8| 2| 3| 2| 2| 2| 2| 2| 2| 8| 3| 5| 8
 8| 5| 2| 2| 2| 3| 2| 8| 8| 8| 8| 2| 8| 5| 5| 8
 8| 5| 2| 2| 8| 2| 2| 8| 5| 5| 5| 2| 2| 2| 8| 8
 8| 8| 8| 8| 8| 8| 8| 8| 8| 8| 8| 8| 8| 8| 8| 8
 8| 8| 8| 8| 8| 8| 8| 8| 8| 8| 8| 8| 8| 8| 8| 8
