 8| 8| 8| 8| 8| 8| 8| 8| 8| 8| 8| 8| 8| 8| 8| 8
 8| 8| 8| 8| 8| 2| 8| 2| 2| 8| 8| 8| 8| 8| 8| 8
 8| 8| 8| 8| 8| 5| 2| 5| 2| 8| 8| 8| 8| 8| 8| 8
 8| 8| 8| 8| 8| 2| 8| 3| 2| 8| 8| 8| 8| 8| 8| 8
 8| 8| 8| 2| 5| 3| 2| 2| 2| 3| 2| 8| 2| 2| 8| 8
 8| 8| 8| 2| 3| 5| 3| 5| 2| 5| 3| 2| 2| 2| 8| 8
 8| 5| 2| 2| 3| 7| 5| 3| 5| 8| 8| 5| 2| 2| 8| 8
 8| 8| 3| 8| 2| 3| 8| 8| 2| 2| 8| 2| 3| 8| 8| 8
 8| 8| 2| 2| 8| 2| 2| 8| 8| 2| 8| 8| 2| 8| 8| 8
 8| 8| 8| 2| 2| 2| 5| 8| 2| 3| 2| 2| 5| 8| 8| 8
 8| 8| 8| 8| 8| 2| 2| 2| 2| 2| 2| 8| 2| 8| 8| 8
 8| 8| 8| 8| 8| 8| 8| 8| 8| 8| 8| 8| 8| 8| 8| 8
