 8| 8| 8| 8| 8| 8| 8| 8| 8| 8| 8| 8| 8| 8| 8| 8
 8| 8| 2| 2| 8| 8| 8| 2| 2| 2| 2| 2| 2| 2| 8| 8
 8| 8| 2| 3| 2| 3| 2| 2| 8| 2| 8| 8| 8| 2| 8| 8
 8| 2| 2| 2| 3| 2| 8| 8| 8| 5| 2| 5| 2| 2| 8| 8
 8| 2| 8| 3| 3| 2| 8| 8| 5| 2| 5| 2| 8| 2| 8| 8
 8| 2| 2| 2| 2| 3| 8| 5| 2| 5| 2| 2| 8| 2| 8| 8
 8| 2| 3| 8| 2| 2| 3| 2| 5| 8| 5| 2| 2| 2| 8| 8
 8| 2| 2| 3| 2| 2| 8| 5| 2| 2| 2| 5| 8| 8| 8| 8
 8| 2| 3| 8| 8| 8| 8| 8| 8| 2| 7| 8| 8| 8| 8| 8
 8| 2| 2| 8| 8| 8| 8| 8| 8| 8| 8| 8| 8| 8| 8| 8
 8| 8| 8| 8| 8| 8| 8| 8| 8| 8| 8| 8| 8| 8| 8| 8
 8| 8| 8| 8| 8| 8| 8| 8| 8| 8| 8| 8| 8| 8| 8| 8
