 8| 8| 8| 8| 8| 8| 8| 8| 8| 8| 8| 8| 8| 8| 8| 8
 8| 2| 2| 9| 2| 2| 1| 1| 8| 8| 8| 8| 1| 1| 1| 8
 8| 2| 3| 2| 2| 1| 1| 8| 2| 5| 5| 5| 8| 1| 1| 8
 8| 2| 2| 1| 1| 1| 8| 2| 3| 2| 8| 2| 8| 1| 1| 8
 8| 2| 1| 1| 1| 8| 2| 3| 2| 5| 5| 5| 8| 1| 1| 8
 8| 1| 1| 1| 8| 8| 3| 2| 2| 8| 2| 8| 1| 1| 1| 8
 8| 1| 1| 8| 2| 3| 7| 8| 2| 2| 2| 8| 1| 1| 1| 8
 8| 1| 1| 8| 2| 2| 3| 2| 8| 2| 2| 8| 1| 1| 2| 8
 8| 1| 1| 8| 2| 2| 2| 3| 2| 2| 8| 1| 1| 2| 2| 8
 8| 1| 1| 1| 8| 2| 2| 8| 2| 2| 8| 1| 2| 4| 2| 8
 8| 8| 1| 1| 1| 8| 8| 8| 8| 8| 1| 2| 6| 2| 2| 8
 8| 8| 8| 8| 8| 8| 8| 8| 8| 8| 8| 8| 8| 8| 8| 8
