 8| 8| 8| 8| 8| 8| 8| 8| 8| 8| 8| 8| 8| 8| 8| 8
 8| 8| 8| 8| 8| 8| 8| 8| 8| 8| 8| 8| 8| 8| 8| 8
 8| 8| 8| 8| 8| 8| 8| 8| 8| 8| 8| 8| 8| 8| 8| 8
 8| 8| 8| 8| 8| 2| 2| 8| 2| 2| 8| 8| 8| 8| 8| 8
 8| 8| 8| 8| 8| 5| 3| 5| 3| 5| 2| 7| 8| 8| 8| 8
 8| 8| 8| 2| 2| 5| 2| 8| 3| 5| 3| 2| 8| 8| 8| 8
 8| 8| 8| 2| 8| 3| 2| 5| 3| 5| 2| 8| 8| 8| 8| 8
 8| 8| 8| 2| 2| 5| 2| 3| 3| 2| 8| 8| 8| 8| 8| 8
 8| 8| 8| 8| 8| 2| 2| 8| 2| 2| 8| 8| 8| 8| 8| 8
 8| 8| 8| 8| 8| 8| 8| 8| 8| 8| 8| 8| 8| 8| 8| 8
 8| 8| 8| 8| 8| 8| 8| 8| 8| 8| 8| 8| 8| 8| 8| 8
 8| 8| 8| 8| 8| 8| 8| 8| 8| 8| 8| 8| 8| 8| 8| 8
