 8| 8| 8| 8| 8| 8| 8| 8| 8| 8| 8| 8| 8| 8| 8| 8
 8| 8| 8| 8| 8| 8| 8| 8| 8| 8| 8| 8| 8| 8| 8| 8
 8| 8| 8| 8| 8| 8| 8| 8| 8| 8| 8| 8| 8| 8| 8| 8
 8| 8| 8| 8| 8| 8| 2| 7| 5| 2| 8| 8| 8| 8| 8| 8
 8| 8| 8| 8| 2| 5| 2| 3| 8| 2| 8| 8| 8| 8| 8| 8
 8| 8| 8| 8| 2| 3| 2| 5| 2| 3| 2| 8| 8| 8| 8| 8
 8| 8| 8| 8| 8| 2| 8| 2| 3| 5| 2| 8| 8| 8| 8| 8
 8| 8| 8| 8| 8| 2| 5| 3| 2| 8| 8| 8| 8| 8| 8| 8
 8| 8| 8| 8| 8| 8| 2| 2| 8| 8| 8| 8| 8| 8| 8| 8
 8| 8| 8| 8| 8| 8| 8| 8| 8| 8| 8| 8| 8| 8| 8| 8
 8| 8| 8| 8| 8| 8| 8| 8| 8| 8| 8| 8| 8| 8| 8| 8
 8| 8| 8| 8| 8| 8| 8| 8| 8| 8| 8| 8| 8| 8| 8| 8
