 8| 8| 8| 8| 8| 8| 8| 8| 8| 8| 8| 8| 8| 8| 8| 8
 8| 8| 8| 8| 8| 8| 8| 8| 8| 8| 8| 8| 8| 8| 8| 8
 8| 8| 8| 8| 8| 8| 8| 2| 2| 8| 8| 8| 8| 8| 8| 8
 8| 8| 8| 8| 8| 2| 2| 2| 2| 8| 8| 8| 8| 8| 8| 8
 8| 8| 8| 8| 2| 3| 2| 3| 2| 2| 2| 8| 8| 8| 8| 8
 8| 8| 8| 8| 2| 8| 3| 8| 2| 8| 3| 8| 8| 8| 8| 8
 8| 8| 8| 8| 2| 5| 2| 5| 3| 5| 2| 2| 8| 8| 8| 8
 8| 8| 8| 8| 8| 5| 7| 5| 2| 8| 3| 2| 8| 8| 8| 8
 8| 8| 8| 8| 8| 8| 8| 5| 2| 2| 2| 8| 8| 8| 8| 8
 8| 8| 8| 8| 8| 8| 8| 2| 2| 8| 8| 8| 8| 8| 8| 8
 8| 8| 8| 8| 8| 8| 8| 8| 8| 8| 8| 8| 8| 8| 8| 8
 8| 8| 8| 8| 8| 8| 8| 8| 8| 8| 8| 8| 8| 8| 8| 8
